#################S#####################
#               #         #           #
# ###### ######## ####### # ###########
#      #          #     # # #         #
# ### ########### ####### # # ######  #
# #               #     # # #      #  #
# #      ######## # ### # # ########  #
# ########      # # # #               #
#        ######## #   # ###############
# ######          ##### #    #        #
# ###### ######## #     #    # ###### #
#        #      # ############ ##     #
# ###### #      #               # #####
# #    # ############### ###### # #   #
# #    #                        # #   #
# #    # ######################## #####
# #    #                              #
# ###### ############ ######### # #####
#        #                    # # #   #
###############################E#######